1111111111111
1C10000E10001
101C011110001
1010110000001
1010000010001
100C100P10C01
1111111111111
