111111
1C0001
101011
1E1011
111P01
100001
100101
111111
